#####################################
#S             #                    #
# ################################# #
#E#                                 #
# ############### ############# ### #
# #                           #   # #
# # ##################### ### # ### #
# # #                 # #   # #   # #
# ######### ######### # # ### # ### #
# #                 # # # #   # # # #
# # ################# # ##### # # # #
# #                 # #       # # # #
#   ######### # ##### ####### ### # #
# # #     # # # #     #       #   # #
# ####### # # # # ################# #
# #     # # # # #         # #       #
# # ### # # # # # ######### ####### #
# # #   # # # # #         #         #
# # ##### # ##### ######### # ##### #
# #               #       # # #     #
# ############### # ####### # # ### #
#               # #         # #   # #
################# ########### ### # #
#                 #           #   # #
# ################# ###########   # #
# #   #   #   #   # # # #         # #
# # # # # # # # # # # # ### ####### #
#   #   #   #   #   #             ##
#####################################
